,Date,Nbre Positions,Nbre Tickers,Nbre Long,Nbre Short,Exposition Long,Exposition Short,Exposition Totale,Latent PnL
0,2019-11-18,3,3,1,2,14925.06,-59635.57,-44710.51,-511.89000000000124
1,2019-11-21,34,34,13,21,579997.3300000001,-986771.65,-406774.32,-2092.509999999993
2,2019-11-18,6,3,2,4,29850.12,-119271.14,-89421.02000000002,-1023.7800000000026
3,2019-11-21,36,34,13,23,579997.3300000001,-1077052.45,-497055.12,-3384.299999999995
4,2019-11-22,34,34,14,20,783817.57,-1180185.2300000002,-396367.6600000001,808.2200000000107
5,2019-11-18,9,3,3,6,44775.18,-178906.71000000005,-134131.53000000006,-1535.6700000000033
6,2019-11-21,38,34,13,25,579997.3300000001,-1167333.25,-587335.9199999999,-4676.0899999999965
7,2019-11-22,34,34,14,20,783817.57,-1180185.2300000002,-396367.6600000001,808.2200000000107
8,2019-11-25,36,36,16,20,1017249.65,-1463879.61,-446629.96,2618.380000000015
9,2019-11-18,12,3,4,8,59700.24,-238542.28,-178842.04000000004,-2047.560000000005
10,2019-11-21,40,34,13,27,579997.3300000001,-1257614.05,-677616.72,-5967.879999999997
11,2019-11-22,34,34,14,20,783817.57,-1180185.2300000002,-396367.6600000001,808.2200000000113
12,2019-11-25,37,36,17,20,1091555.65,-1463879.61,-372323.96,4420.380000000021
13,2019-11-26,38,38,17,21,1191152.5,-1747944.78,-556792.28,-379.9699999999896
14,2019-11-18,15,3,5,10,74625.3,-298177.85,-223552.55000000005,-2559.450000000005
15,2019-11-21,42,34,13,29,579997.3300000001,-1347894.85,-767897.52,-7259.67
16,2019-11-22,34,34,14,20,783817.57,-1180185.2300000002,-396367.6600000001,808.2200000000107
17,2019-11-25,38,36,18,20,1165861.65,-1463879.61,-298017.96,6222.380000000028
18,2019-11-26,76,38,34,42,2644685.41,-3794126.29,-1149440.88,-1956.2899999999781
19,2019-11-18,18,3,6,12,89550.36,-357813.42,-268263.0600000001,-3071.3400000000065
20,2019-11-21,44,34,13,31,579997.3300000001,-1438175.65,-858178.3200000002,-8551.460000000001
21,2019-11-22,34,34,14,20,783817.57,-1180185.2300000002,-396367.6600000001,808.2200000000107
22,2019-11-25,39,36,19,20,1240167.65,-1463879.61,-223711.96,8024.380000000034
23,2019-11-26,114,38,51,63,4098218.32,-5840307.8,-1742089.4800000002,-3532.6099999999697
24,2019-11-18,20,3,6,14,89550.36,-417448.99,-327898.6300000001,-3373.4400000000073
25,2019-11-21,46,34,13,33,579997.3300000001,-1528456.45,-948459.12,-9843.250000000002
26,2019-11-22,34,34,14,20,783817.57,-1180185.2300000002,-396367.6600000001,808.2200000000107
27,2019-11-25,40,36,20,20,1314473.65,-1463879.61,-149405.9599999999,9826.380000000041
28,2019-11-26,118,38,53,65,4232577.5200000005,-5975149.98,-1742572.4600000004,-6726.369999999978
29,2019-11-29,50,50,21,29,1595521.78,-2352011.85,-756490.07,109.61000000001404
30,2019-11-18,22,3,6,16,89550.36,-477084.56,-387534.20000000007,-3675.540000000007
31,2019-11-21,48,34,13,35,579997.3300000001,-1618737.25,-1038739.92,-11135.040000000008
32,2019-11-22,34,34,14,20,783817.57,-1180185.2300000002,-396367.6600000001,808.2200000000107
33,2019-11-25,41,36,21,20,1388779.65,-1463879.61,-75099.9599999999,11628.380000000045
34,2019-11-26,122,38,55,67,4366936.720000002,-6109992.159999997,-1743055.4399999997,-9920.129999999986
35,2019-11-29,65,50,24,41,1833715.7,-2918304.63,-1084588.93,3105.0400000000104
36,2019-12-04,36,36,18,18,1616485.99,-2039407.03,-422921.04,-6025.039999999978
37,2019-11-18,24,3,6,18,89550.36,-536720.13,-447169.77,-3977.640000000008
38,2019-11-21,50,34,13,37,579997.3300000001,-1709018.05,-1129020.7200000002,-12426.830000000007
39,2019-11-22,34,34,14,20,783817.57,-1180185.2300000002,-396367.6600000001,808.2200000000107
40,2019-11-25,42,36,22,20,1463085.65,-1463879.61,-793.9599999999042,13430.380000000048
41,2019-11-26,125,38,57,68,4501295.92,-6229921.199999997,-1728625.2799999998,-11631.259999999993
42,2019-11-29,79,50,27,52,2071909.62,-3349952.1900000004,-1278042.57,9878.910000000013
43,2019-12-04,38,36,19,19,1659151.21,-2069115.23,-409964.0200000001,-5142.579999999978
44,2019-12-05,37,37,18,19,1844664.35,-2378412.48,-533748.13,-16640.40999999998
45,2019-11-18,26,3,6,20,89550.36,-596355.7000000001,-506805.34,-4279.740000000008
46,2019-11-21,52,34,13,39,579997.3300000001,-1799298.85,-1219301.5200000005,-13718.62000000001
47,2019-11-22,34,34,14,20,783817.57,-1180185.2300000002,-396367.6600000001,808.2200000000107
48,2019-11-25,43,36,23,20,1537391.65,-1463879.61,73512.0400000001,15232.380000000056
49,2019-11-26,127,38,58,69,4605985.12,-6349850.239999997,-1743865.12,-13664.389999999998
50,2019-11-29,93,50,30,63,2310103.54,-3781599.75,-1471496.21,16652.780000000013
51,2019-12-04,39,36,19,20,1659151.21,-2098823.43,-439672.2200000001,-4704.699999999977
52,2019-12-05,43,37,21,22,2111793.23,-2699004.33,-587211.1,-21815.049999999974
53,2019-12-06,34,34,17,17,1870759.34,-2266669.61,-395910.27000000014,-13144.539999999983
54,2019-11-18,28,3,6,22,89550.36,-655991.2700000001,-566440.91,-4581.840000000008
55,2019-11-21,54,34,13,41,579997.3300000001,-1889579.65,-1309582.3200000005,-15010.410000000007
56,2019-11-22,34,34,14,20,783817.57,-1180185.2300000002,-396367.6600000001,808.2200000000107
57,2019-11-25,44,36,24,20,1611697.65,-1463879.61,147818.0400000001,17034.380000000063
58,2019-11-26,129,38,59,70,4710674.32,-6469779.2799999975,-1759104.96,-15697.519999999995
59,2019-11-29,107,50,33,74,2548297.46,-4213247.3100000005,-1664949.85,23426.65000000002
60,2019-12-04,40,36,19,21,1659151.21,-2128531.6300000004,-469380.42,-4266.819999999975
61,2019-12-05,49,37,24,25,2378922.1100000003,-3019596.18,-640674.0699999997,-26989.689999999977
62,2019-12-06,35,34,18,17,1910261.5,-2266669.61,-356408.1100000001,-12694.359999999986
63,2019-12-09,34,34,17,17,2052122.67,-2475518.59,-423395.92,-16501.549999999992
64,2019-11-18,30,3,6,24,89550.36,-715626.8400000002,-626076.4800000001,-4883.9400000000105
65,2019-11-21,56,34,13,43,579997.3300000001,-1979860.45,-1399863.12,-16302.200000000017
66,2019-11-22,34,34,14,20,783817.57,-1180185.2300000002,-396367.6600000001,808.2200000000107
67,2019-11-25,45,36,25,20,1686003.65,-1463879.61,222124.04000000007,18836.38000000007
68,2019-11-26,131,38,60,71,4815363.5200000005,-6589708.3199999975,-1774344.7999999996,-17730.649999999998
69,2019-11-29,121,50,36,85,2786491.38,-4644894.87,-1858403.49,30200.520000000015
70,2019-12-04,41,36,19,22,1659151.21,-2158239.8300000005,-499088.62000000005,-3828.9399999999737
71,2019-12-05,55,37,27,28,2646050.99,-3340188.0300000007,-694137.0399999997,-32164.32999999997
72,2019-12-06,36,34,19,17,1949763.66,-2266669.61,-316905.9500000001,-12244.179999999988
73,2019-12-09,68,34,33,35,4535621.14,-5372959.81,-837338.6700000003,-37420.859999999986
74,2019-12-10,1,1,1,0,14716.64,0.0,14716.64,41.35999999999978
75,2019-11-18,32,3,6,26,89550.36,-775262.41,-685712.05,-5186.040000000009
76,2019-11-21,58,34,13,45,579997.3300000001,-2070141.25,-1490143.92,-17593.99000000002
77,2019-11-22,34,34,14,20,783817.57,-1180185.2300000002,-396367.6600000001,808.2200000000107
78,2019-11-25,46,36,26,20,1760309.65,-1463879.61,296430.0400000001,20638.38000000008
79,2019-11-26,133,38,61,72,4920052.720000002,-6709637.36,-1789584.64,-19763.78
80,2019-11-29,134,50,38,96,2905262.1,-5076542.43,-2171280.33,36132.640000000014
81,2019-12-04,42,36,19,23,1659151.21,-2187948.0300000007,-528796.8200000001,-3391.0599999999718
82,2019-12-05,61,37,30,31,2913179.87,-3660779.88,-747600.0099999994,-37338.96999999997
83,2019-12-06,37,34,20,17,1989265.82,-2266669.61,-277403.79000000004,-11793.999999999987
84,2019-12-09,71,34,36,35,4994875.66,-5372959.81,-378084.15000000014,-42390.45
85,2019-12-10,1,1,1,0,14716.64,0.0,14716.64,41.35999999999978
86,2019-12-11,34,34,16,18,2399651.67,-3106939.35,-707287.68,-16530.73999999998
87,2019-11-18,34,3,6,28,89550.36,-834897.9800000001,-745347.62,-5488.1400000000085
88,2019-11-21,60,34,13,47,579997.3300000001,-2160422.0500000003,-1580424.72,-18885.780000000024
89,2019-11-22,34,34,14,20,783817.57,-1180185.2300000002,-396367.6600000001,808.2200000000107
90,2019-11-25,47,36,27,20,1834615.6500000001,-1463879.6099999999,370736.0400000001,22440.380000000085
91,2019-11-26,135,38,62,73,5024741.920000001,-6829566.4,-1804824.4799999997,-21796.91000000001
92,2019-11-29,147,50,40,107,3024032.82,-5508189.990000001,-2484157.17,42064.76000000001
93,2019-12-04,43,36,19,24,1659151.21,-2217656.23,-558505.02,-2953.1799999999707
94,2019-12-05,67,37,33,34,3180308.75,-3981371.73,-801062.9799999992,-42513.609999999964
95,2019-12-06,38,34,21,17,2028767.9799999997,-2266669.61,-237901.63000000003,-11343.81999999999
96,2019-12-09,74,34,39,35,5454130.18,-5372959.81,81170.3699999999,-47360.04
97,2019-12-10,1,1,1,0,14716.64,0.0,14716.64,41.35999999999978
98,2019-12-11,42,34,23,19,3137600.5799999996,-3347703.19,-210102.6099999999,-22770.069999999996
99,2019-12-12,27,27,9,18,1729955.42,-3070523.3,-1340567.88,-11585.40999999996
